+ + + + + +
+ + + - - +
+ + + - - +
+ % X @ - +
+ - - - + +
+ + + + + +